    11111111111111111111111111111111        111111
11111000000000000000000000001111111111      110000
10000000000000000000001000001110000001111 11000000
10000000000000000000000000001000100000101100000000
10000000000000000000000000001110000000010000000000
11110100000000011111000000000000000000011110000000
1000100000000011   1100000000000000000010000000000
100010000000011     110000000000000000001000000000
11111111111111       11111111111111111111        1