NO ./path_to_the_north_texture
SO ./path_to_the_south_texture
WE ./path_to_the_west_texture
EA ./path_to_the_east_texture

F 1,2,3
C 4,5,6

    11111111111111111111111111111111        111111
11111000000000000000000000001111111111      110001
10000000000000000000001000001110000001111 11000001
10000000111100000000000000001000100000101100000001
10000000000000000000000000001110000000000000000001
10000000000000000000000000000110000000000000000001
100000110000000000000S0000001110000000000000000001
100001  100000000000000000001 10000000000000000001
100001  100000000000000000001 10000000000000000001
100001  100000000000000000001 10000000000000000001
10000011000000000000000000001 10000000000000000001
10000000000000000000000000001110000000000000000001
11110100000000011111000000000000000000011110000001
1000100000000011   1100000000000000000010000000001
100010000000011     110000000000000000001111111111
11111111111111       11111111111111111111
