NO ./texture/set1/n.xpm
SO ./texture/set1/s.xpm
WE ./texture/set1/w.xpm
EA ./texture/set1/e.xpm


F 18,53,25
C 153,204,255


    1111111111111111111111111111         1111
1111100000000000000000000111111111      110001
100000000000000001000001110000001111 11100001
1000000011110000001000001000100000101100000001
1000100000000000000100001110000000001000000001
1000000000000S00000010000110000000000100000001
1000001100000000000000001110000000000010000001
100001  10000000011100001 10001100110001000001
100001  10000100000011111 10000000000010000001
100001  10000100000000001 10000000000100000001
1000001100010010000000001 10000000001000000001
1000000000000000000000001110000000000000000001
1111010000000001111100000000000000011110000001
1000100000000011   110000000000000010000000001
100010000000011     11000000000000001111111111
11111111111111       1111111111111111111
