NO ./texture/set_1/n.xpm
SO ./texture/set_1/s.xpm
WE ./texture/set_1/w.xpm
EA ./texture/set_1/e.xpm

F 1,2,3
C 4,5,6

    1111111111111111111111111111         1111
1111100000000000000000000111111111      110001
100000000000000001000001110000001111 11100001
1000000011110000000000001000100000101100000001
1000000000000000000000001110000000000000000001
1000000000000000000000000110000000000000000001
10000011000000000S0000001110000000000000000001
100001  10000000000000001 10000000000000000001
100001  10000000000000001 10000000000000000001
100001  10000000000000001 10000000000000000001
1000001100000000000000001 10000000000000000001
1000000000000000000000001110000000000000000001
1111010000000001111100000000000000011110000001
1000100000000011   110000000000000010000000001
100010000000011     11000000000000001111111111
11111111111111       1111111111111111
