NO ./texture/set0/n.xpm
SO ./texture/set0/s.xpm
WE ./texture/set0/w.xpm
EA ./texture/set0/e.xpm

D ./texture/set0/d.xpm

F 50,50,50
C 200,200,200

1111111
1000D01
1101101
10D0001
1001111
1000DS1
1111111
