NO ./texture/set_1/n.xpm
SO ./texture/set_1/s.xpm
WE ./texture/set_1/w.xpm
EA ./texture/set_1/e.xpm

D ./texture/set_1/d.xpm

F 18,53,25
C 153,204,255

    1111111111111111111111111111
1111100000000000000000000111111111
1000000000000000000000001110000001
1000000000D00000000000000DD0000001
10000011100000000S0000001110000001
100001   1000000000000001 10000001
100001 1 1000000100000001 10000001
1000011011000000D00000001 10000001
1000000D00000000000000001 10000001
1111111111111111000000DD1110000001
               11111DDD00000000001
                   110000000000001
                    11000011111111
                     11111111
