NO ./texture/set_1/n.xpm
SO ./texture/set_1/s.xpm
WE ./texture/set_1/w.xpm
EA ./texture/set_1/e.xpm

F 220,100,255
C 225,30,0

           1
           1
           1
           1
           1
           1
           1
           1 
        1111111
111111111000W0111111111
        1111111
           1
           1
           1
           1
           1
           1
           1
           1