NO ./texture/set_1/n.xpm
SO ./texture/set_1/s.xpm
WE ./texture/set_1/w.xpm
EA ./texture/set_1/e.xpm

D ./texture/set_1/d.xpm

F 18,53,25
C 153,204,255

1111111
1000D01
1111101
10D0001
1011111
1000DN1
1111111
