NO ./texture/set_1/n.xpm
SO ./texture/set_1/s.xpm
WE ./texture/set_1/w.xpm
EA ./texture/set_1/e.xpm

D ./texture/set_1/d.xpm

F 18,53,25
C 153,204,255

111111111
100000001
10D000D01
1000E0001
10D000D01
100000001
111111111
